|------------------------------------------------------------------------------|
|                                 ECO   REPORT                                 |
|                                                                    Page   1  |
|------------------------------------------------------------------------------|
|  C:/Users/zq2154/Documents/GitHub/SEA/Cadence/SMA_fabA/layout/test.brd       |
|                                                    Fri Feb 16 10:26:13 2018  |
|------------------------------------------------------------------------------|
|------------------------------------------------------------------------------|
|                                                                              |
|   Total ECO changes reported:       0                                        |
|------------------------------------------------------------------------------|
